Minimal pairs for [a] vs. [à] in initial position:
albaro 	àlbaro 		

Minimal pairs for [a] vs. [à] in medial position:
£asa 	£asà 		
adata 	adatà 		
adota 	adotà 		
adotar 	adotàr 		
ba£a 	ba£à 		
bataja 	batàja 		
batajar 	batajàr 		
baxa 	baxà 		
bocia 	bocià 		
bordar 	bordàr 		
botanego 	botànego 		
brinca 	brincà 		
britaneghe 	britàneghe 		
canbia 	canbià 		
canta 	cantà 		
cao 	cào 		
capita 	capità 		
capitan 	capitàn 		
cata 	catà 		
cava 	cavà 		
ciama 	ciamà 		
ciamame 	ciàmame 		
ciapa 	ciapà 		
clasego 	clàsego 		
cofa 	cofà 		
comanda 	comandà 		
consonante 	consonànte 		
conta 	contà 		
corasa 	coràsa 		
crea 	creà 		
da 	dà 		
descoverxar 	descoverxàr 		
deventa 	deventà 		
dia£eta£i 	dia£età£i 		
dimanda 	dimandà 		
dopara 	doparà 		
doparar 	doparàr 		
dopera 	doperà 		
dura 	durà 		
entra 	entrà 		
'fa 	'fà 		
farghe£a 	fàrghe£a 		
ferma 	fermà 		
fi£a 	fi£à 		
forsa 	forsà 		
fortuna 	fortunà 		
funsiona 	funsionà 		
grafego 	gràfego 		
indrioman 	indriomàn 		
influensa 	influensà 		
inluamara 	inluamarà 		
insenbra 	insenbrà 		
interdenta£i 	interdentà£i 		
invita 	invità 		
ixo£a 	ixo£à 		
la 	là 		
lontan 	lontàn 		
magna 	magnà 		
majo 	màjo 		
manca 	mancà 		
manda 	mandà 		
marca 	marcà 		
mascio 	màscio 		
mena 	menà 		
menaso 	menàso 		
meta 	metà 		
mostra 	mostrà 		
na 	nà 		
nda 	ndà 		
nega 	negà 		
nota 	notà 		
opta 	optà 		
osidenta£i 	osidentà£i 		
paca 	pacà 		
parecia 	parecià 		
parla 	parlà 		
pasa 	pasà 		
paso 	pàso 		
paxe 	pàxe 		
pensa 	pensà 		
pesa 	pesà 		
pexa 	pexà 		
piovega 	piovegà 		
porta 	portà 		
posta 	postà 		
pra 	prà 		
pratica 	praticà 		
prexenta 	prexentà 		
priva 	privà 		
proa 	proà 		
proar 	proàr 		
programa 	programà 		
pronunsia 	pronunsià 		
pronunsiar 	pronunsiàr 		
pronunzia 	pronunzià 		
rabia 	rabià 		
rancura 	rancurà 		
recluta 	reclutà 		
refuda 	refudà 		
resitar 	resitàr 		
rimarcar 	rimarcàr 		
riva 	rivà 		
rixaltar 	rixaltàr 		
roba 	robà 		
ruspa 	ruspà 		
salta 	saltà 		
salva 	salvà 		
salvadego 	salvàdego 		
sara 	sarà 		
sbalia 	sbalià 		
scanpa 	scanpà 		
scianta 	sciànta 		
sciao 	sciào 		
sciapo 	sciàpo 		
scominsia 	scominsià 		
scrivar 	scrivàr 		
scuriato£i 	scuriàto£i 		
segonda 	segondà 		
senta 	sentà 		
sera 	serà 		
sevita 	sevità 		
si£abeghe 	si£àbeghe 		
sicura 	sicurà 		
siga 	sigà 		
smara 	smarà 		
specia£i 	specià£i 		
speta 	spetà 		
spiega 	spiegà 		
sta 	stà 		
standoghe 	stàndoghe 		
studia 	studià 		
suga 	sugà 		
supa 	supà 		
taca 	tacà 		
taja 	tajà 		
talian 	taliàn 		
tira 	tirà 		
torna 	tornà 		
trata 	tratà 		
vantaxo 	vantàxo 		
varda 	vardà 		
venesian 	venesiàn 		
vista 	vistà 		
vo£a 	vo£à 		
voca£e 	vocà£e 		
voca£i 	vocà£i 		
xa 	xà 		
xonta 	xontà 		
xuga 	xugà 		
xugar 	xugàr 		

Minimal pairs for [a] vs. [à] in final position:
