Minimal pairs for [e] vs. [è] in initial position:
e 	è 		
esar 	èsar 		

Minimal pairs for [e] vs. [è] in medial position:
bei 	bèi 		
caste£o 	castè£o 		
coreta 	corèta 		
de 	dè 		
dei 	dèi 		
deso 	dèso 		
dia£eti 	dia£èti 		
dia£eto 	dia£èto 		
direto 	dirèto 		
feto 	fèto 		
fonedega 	fonèdega 		
fonedego 	fonèdego 		
fonemi 	fonèmi 		
forse£e 	forsè£e 		
ghe 	ghè 		
gheto 	ghèto 		
le 	lè 		
lexar 	lèxar 		
lexe 	lèxe 		
mejo 	mèjo 		
mexo 	mèxo 		
nanare£a 	nanarè£a 		
ne 	nè 		
n'onbre£o 	n'onbrè£o 		
parke 	parkè 		
peke 	pèke 		
perdarse 	pèrdarse 		
pesa 	pèsa 		
piane£o 	pianè£o 		
pie 	piè 		
presia 	prèsia 		
problemi 	problèmi 		
putei 	putèi 		
rego£a 	règo£a 		
rego£e 	règo£e 		
resita 	rèsita 		
resto 	rèsto 		
rieso 	rièso 		
rispeta 	rispèta 		
rispeto 	rispèto 		
rubesteghi 	rubèsteghi 		
se 	sè 		
seco£i 	sèco£i 		
seco£o 	sèco£o 		
serte 	sèrte 		
sesto 	sèsto 		
seto 	sèto 		
seto… 	sèto… 		
sevita 	sèvita 		
sguelto 	sguèlto 		
spece 	spèce 		
speta 	spèta 		
ste 	stè 		
ste£a 	stè£a 		
steto 	stèto 		
storie£e 	storiè£e 		
tera 	tèra 		
tera… 	tèra… 		
teren 	terèn 		
torne 	tornè 		
ve 	vè 		
vecio 	vècio 		
venedeghe 	venèdeghe 		
vero 	vèro 		
verta 	vèrta 		
verxar 	vèrxar 		
xenare 	xènare 		
xero 	xèro 		

Minimal pairs for [e] vs. [è] in final position:
