Minimal pairs for [o] vs. [ó] in initial position:
o 	ó 		
oltimo 	óltimo 		
ondaxe 	óndaxe 		
ongie 	óngie 		
orca 	órca 		
orco 	órco 		

Minimal pairs for [o] vs. [ó] in medial position:
aprovasion 	aprovasión 		
ba£on 	ba£ón 		
benon 	benón 		
bocon 	bocón 		
canton 	cantón 		
cognosar 	cognósar 		
cognoso 	cognóso 		
cogo 	cógo 		
comision 	comisión 		
concluxion 	concluxión 		
confuxion 	confuxión 		
conpetision 	conpetisión 		
corar 	córar 		
core 	córe 		
custion 	custión 		
decixion 	decixión 		
distinsion 	distinsión 		
do 	dó 		
dodaxe 	dódaxe 		
fioi 	fiói 		
generasioni 	generasióni 		
inaxonta 	inaxónta 		
laoro 	laóro 		
letore 	letóre 		
letori 	letóri 		
l'onbre£on 	l'onbre£ón 		
maravejoxa 	maravejóxa 		
mision 	misión 		
mori 	móri 		
nathion 	nathión 		
noador 	noadór 		
nova 	nóva 		
novi 	nóvi 		
novo 	nóvo 		
paron 	parón 		
poco 	póco 		
poke 	póke 		
poki 	póki 		
ponto 	pónto 		
poso 	póso 		
postasion 	postasión 		
proa 	próa 		
proar 	próar 		
produsion 	produsión 		
propor 	propór 		
region 	región 		
ricreasion 	ricreasión 		
rosi 	rósi 		
roso 	róso 		
sco£a 	scó£a 		
seconda 	secónda 		
segonda 	segónda 		
siga£on 	siga£ón 		
sior 	siór 		
so 	só 		
so£usion 	so£usión 		
soi 	sói 		
sora 	sóra 		
soto 	sóto 		
toa 	tóa 		
toco 	tóco 		
togo 	tógo 		
tolto 	tólto 		
tose 	tóse 		
toxe 	tóxe 		
tradision 	tradisión 		
tradusion 	tradusión 		
vinsitor 	vinsitór 		
vo£a 	vó£a 		
xo 	xó 		
xontate 	xóntate 		
xovene 	xóvene 		

Minimal pairs for [o] vs. [ó] in final position:
