In particolare - Specifically
Pronto soccorso - First aid
Tasso di crescita - Growth rate
Carta igienica - Toilet paper
Leasing finanziario - Financial leasing
Valori mobiliari - Transferable securities
Consiglio di amministrazione - Management Board
Regno Unito - United Kingdom
Paesi Bassi - Netherlands
personal computer - personal computers
Tasso di rendimento - Rate of yield
valore aggiunto - value added
Ministero della sanitˆ - Ministry of Health
Nuova Zelanda - New Zealand
Arabia Saudita - Saudi Arabia
allo scopo di - The purpose of such consultations shall be
mercato locale - Local market
Task Force - Task Force
costo totale - Total costs
zona di produzione - production area
Di conseguenza - Accordingly it follows that
Unitˆ di misura - Units of measurement
Per esempio - For example
In caso - In the event of
Variazione delle scorte - Changes in inventories
lavoratori dipendenti - employees
Gran Bretagna - Great Britain
Repubblica popolare cinese - People's Republic of China
mezzi di trasporto - means of transport
Stati Uniti - United States of America
Unione europea - European Union
Dato che - Since
Conto profitti e perdite - Profit and loss accounts
carta di circolazione - registration certificate
MERCATO INTERNO - INTERNAL MARKET
Al riguardo - In this connection
SIERRA LEONE - SIERRA LEONE
unitˆ monetaria - currency unit
tasso di cambio - conversion rate
in base a - based on
Ordine del giorno - Agenda
Corte dei conti - Court of Auditors
a condizione che - provided that
Carta commerciale - Trade bills
PREZZO DI RIFERIMENTO - REFERENCE PRICES
vale a dire - These are
Ordine pubblico - Public policy
Santa Lucia - Saint Lucia
Piano di volo - Flight Plan
Flusso di cassa - Cash flow
America latina - Latin America
Valore contabile - Book value
Vendita abbinata - Tying
mass media - the media
tasso d'interesse - interest rate
banche dati - databases
Gioia Tauro - Gioia Tauro
La Spezia - La Spezia
nome comune - common name
imposta sul valore aggiunto - value added tax
fisica sperimentale - experimental physics
Tasso di profitto - Profit rate
Capitale circolante - Circulating capital
Pesce spada - Swordfish
Premio supplementare - Supplementary premium
Direttore amministrativo - Administrative Director
Cabina di guida - Driver's cab
NUOVA CALEDONIA - NEW CALEDONIA